###################
#####.....##G..####
#####.....##G..####
#.........##G.....#
#....####...###...#
#....#S##...###...#
#...##......###...#
#...##...######...#
###I##...#.I###...#
#...######....#...#
#.............#...#
#.........#...#...#
#.........#.......#
###########....####
###########....####
###################