#################
#################
##S............##
##############.##
##############.##
##..........I#.##
##.########.##.##
##.########.##.##
##.##...G##.##.##
##.##.#####.##.##
##.##.#####.##.##
##.##.......##.##
##.###########.##
##.###########.##
##.............##
##############I##
#################