#########################
#......................G#
#.#######################
#.......................#
#.......................#
#.......................#
#.......................#
#.......................#
#.......................#
#.......................#
#.......................#
#.......................#
#######################.#
#S......................#
#########################