###################
#######.#######.###
###S###.#######.###
###.#.............#
###.###.#######.###
###.###.###.###.###
###.###.###.###.###
###.###.#....G#.###
###.###.###.###.###
###.###.###.###.###
###.#.........#.###
###.###.###.###.###
###.###.###.###.###
###.###########.###
#.................#
###.###########.###
###.###########.###
###################