################
#S.............#
##.............#
##.............#
##.............#
##.............#
##.............#
##......G......#
##.............#
##.............#
##.............#
##.............#
##.............#
##.............#
################