#################
#####.......#####
####.........####
###...........###
##.............##
#...............#
#...............#
#...............#
#...............#
#...............#
#...............#
#...............#
#...............#
#...............#
#...............#
#...............#
#GG###########SS#
#GG###########SS#
#################