#########
#G......#
#######.#
#.......#
#.#######
#.......#
#######.#
#S......#
#########
