#####################
##........#........##
##........#........##
##........#........##
#S........I........G#
##........#........##
##........#........##
##........#........##
#####################
