########################
#SS....................#
#SS....................#
#SS....................#
###....................#
###....................#
####################III#
####################III#
###....................#
###....................#
#GG....................#
#GG....................#
#GG....................#
########################