####################
#S##################
#..................#
#.#..#..#..#..#..#.#
#..................#
##################G#
####################