#.###############
#..............G#
#..............G#
#..............G#
#...............#
#...............#
#...............#
#...............#
#...............#
#...............#
#...............#
#S..............#
#S..............#
#S..............#
###############.#