###################
########...########
######.......######
#####.........#####
####...........####
###.............###
##...............##
##.......#.......##
#S......###.......#
#S.....#####......#
#S......###.......#
##.......#.......##
##...............##
###.............###
####...........####
#####.........#####
######.......######
########GGG########
###################